8
6
100
---D----
---M----
-T------
--------
----H---
---P----