8
6
100
-----D--
---T----
-H------
--------
--H-----
--------