16
12
50
---D------------
---M------------
----------------
----------------
----H-----------
----------------
----TTT---------
----TTT---------
----------------
----------------
-------P--------
----------------