8
6
100
--------
---M----
-T------
--------
---HHH--
--------